_________________________________
_________________________________
_________________________________
_________________________________
______####_____________#_________
P____#____#___________#_________E
#################_#_#############