__________________#______________
__________________#______________
________#######___#______________
_______#__________#______________
______#_______#####______________
P____#________________#_________E
#################_#_#############